       ####
########  ##
#          ###
# @$$ ##   ..#
# $$   ##  ..#
#         ####
###########
